en - 英文
zh - 中文
fr - 法文
es - 西班牙文
de - 德文
ja - 日文
ko - 韩文
it - 意大利文
pt - 葡萄牙文
ru - 俄文
ar - 阿拉伯文
hi - 印地文
th - 泰文
vi - 越南文
tr - 土耳其文
nl - 荷兰文
sv - 瑞典文
da - 丹麦文
no - 挪威文
fi - 芬兰文
pl - 波兰文
cs - 捷克文
hu - 匈牙利文
el - 希腊文
he - 希伯来文
id - 印尼文
ms - 马来文
ro - 罗马尼亚文
sk - 斯洛伐克文
sl - 斯洛文尼亚文
uk - 乌克兰文
bg - 保加利亚文
hr - 克罗地亚文
sr - 塞尔维亚文